###########
#.........#
########..#
#.........#
#.........#
#.###..##.#
#...#.....#
#.........#
########..#
#.........#
#.........#
#.###..##.#
#...#.....#
#.........#
########..#
#.........#
#.........#
#.###..##.#
#...#.....#
#.........#
########..#
#.........#
#.........#
#.###..##.#
#...#.....#
#.........#
########..#
#.........#
#.........#
#.###..##.#
#...#.....#
#.........#
########..#
#.........#
#.........#
#.###..##.#
#...#.....#
###########
