#####################
#..........#...######
#.......#....#......#
#.....#########...###
#.....#....#........#
#......#............#
#.......#..#........#
#...#......#........#
#..###...###....#...#
#...#....#.....#.#..#
#........#......#...#
#####################
